11111111111111111111111
10P000C00000Z00000E0001
11111011111111111111111
11111111111111111111111