11111111111111111111111
10P000C00000000000E0001
100000000000C0000000001
11111111111111111111111