1111111111111111
10P0E0E0C0001111
1111111111111111
