1111111111111111111
100011100P00C0000C1
10100C00010C01E0101
1011110001011110101
1Z1000000C0000C0101
1011110000100110101
10001110C010001C101
100C0000100C0010001
1111111111111111111