1111111111111111
10P000C0C0E01111
1111111111111111