1111111111111
11C111E111111
11C111E111111
11C111E111111
110C01E111111
1111111111111