11111111111111
10111000C0CC01
10001000E10101
10C11111001101
10CCCCC0C01101
10100100001001
101C0111P00101
11111111111111