1111111111111111
10P000E0C0001111
1010000111110001
1111111111111111