1111111111111111111111111
1000000111000000001000001
1000P000000000010101E0001
1000000000000010100000001
10000000000000100C0000001
1111111111111111111111111




1111111111111111111111111
1000000111000000001000001
1000P000000000010101E0001
1000000000000010100000001
10000000000000100C0000001
1111111111111111111111111