11111111111111
10111000C00001
1000C000E00101
1001111100C101
10000000001101
10100C00001001
10100111P00C01
11111111111111