1111111111111111
10P000E0C0001111
1010000111100001
1111111111111111