11111111111111
10111000000001
10001000000101
10011111000101
10P00C0E0C1101
10100100001001
10110111000101
11111111111111