11111111111111
101110CC000001
10Z000000EC101
10011111000101
10000CC0C01101
101C0100C01001
1P110111000101
11111111111111