11111111111111
1011000100C1E1
1000010C010101
1001C011000C01
10010011010001
1P1000C0C10C01
1010Z000C00101
11111111111111