11111111111111
10000000C00001
1000C000E00001
1001111100C001
1P000000C00001
10000C00100001
10000111000C01
11111111111111