1111111111111111111111111
1000000000000C00000000001
100000C000E00000000000001
100000001111100000000C001
1P000000000C0000000000001
1111111111111111111111111